30
3111111111
1110000111
1110000111
0111211110
0000000010
0000000011
0000000001
0000000011
0000000010
0000000115