30
3110001210
0100000100
0100000100
1100000110
1000000010
1111111110
0000000011
0500000001
0100000011
0111111111