20
0001003000
5111001111
0001000101
0111012001
0001011001
0001110001
0011100001
0011011111
0011110000
0000000000