30
5111111113
0001110000
0001010000
0000110000
0001100021
0001110001
0011000011
0110111111
0111111111
0000001000
