30
5111111111
0000000001
1111111001
1000106001
1000106001
3000101111
0000100010
0000200010
0000000010
0000000080
