30
0000131000
0000111000
0000060000
0000066600
0000006000
0000006100
0020080100
0110010111
0110010011
1111111511