30
1111111113
0000660000
0000660000
0000660000
0000660000
0000660000
0000660000
0000660000
2111111118
1111151111
