20
0000011113
0000011000
0000110002
0000100011
0000110001
0000111111
0000111110
0001110000
0001100000
1111111115