40
2111111110
0000000100
0001111100
1111000008
1000000101
1011530101
1060100101
1010111101
1010100001
1110111111
