30
3100000000
1166666666
0000000011
0000000011
0000000111
2111111111
0000000011
0000000111
8111111111
0000000005
