30
0000000000
3111111111
0000000001
0012111111
0010100000
0001100000
1111111100
0000000100
0000001100
0000011115