20
0111111113
0111001000
0111001011
0111010101
0110101011
0111101101
1111111111
1111001111
0110110110
5111111112