35
1111611115
2000000001
0110000001
1110168101
1010100101
1010110101
1010010101
1011010101
1001010101
1301110111
