30
0101050101
1010110101
0101010011
0111112100
0000011111
0000010000
0000011000
0000001111
0000000001
0000003111