20
2111111113
0100000010
0100000010
0100000010
0111111110
0000110000
0000110000
0001111000
0011111100
0111151110