20
3110002000
1110001000
1110001000
1110001111
1000001111
1111001111
0001111100
0000001100
0000111100
1511111111