30
5111111111
0000000001
2111111001
0001001001
1111001111
1000000000
1000001111
1111666001
0001000001
8111031111
